 -4373 -4409 -4459 -4502 -4539 -4568 -4587 -4614 -4631 -4643 -4642 -4632 -4609 -4585 -4543 -4505 -4462 -4494 -4531 -4592 -4642 -4686 -4718 -4754 -4782 -4782 -4781 -4708 -4671 -4612 -4607 -4612 -4651 -4712 -4784 -4819 -4848 -4823 -4822 -4748 -4725 -4695 -4675 -4624 -4551 -4433 -4248 -3899 -3544 -3393 -3288
 -4419 -4456 -4495 -4534 -4568 -4592 -4608 -4620 -4623 -4617 -4600 -4571 -4532 -4489 -4443 -4410 -4396 -4425 -4471 -4525 -4572 -4611 -4639 -4663 -4664 -4638 -4573 -4492 -4416 -4395 -4408 -4454 -4514 -4580 -4642 -4686 -4687 -4620 -4543 -4509 -4512 -4532 -4550 -4548 -4514 -4415 -4218 -3882 -3543 -3318 -3173
 -4436 -4475 -4510 -4548 -4583 -4605 -4624 -4626 -4622 -4604 -4575 -4538 -4490 -4446 -4401 -4387 -4386 -4417 -4451 -4488 -4513 -4538 -4553 -4581 -4563 -4529 -4409 -4338 -4209 -4236 -4248 -4322 -4385 -4438 -4476 -4524 -4516 -4398 -4245 -4270 -4298 -4359 -4399 -4411 -4392 -4299 -4144 -3810 -3493 -3236 -3073
 -4420 -4464 -4502 -4531 -4559 -4586 -4609 -4618 -4615 -4598 -4570 -4535 -4494 -4454 -4425 -4416 -4424 -4442 -4459 -4458 -4454 -4455 -4476 -4513 -4541 -4515 -4453 -4366 -4288 -4245 -4236 -4260 -4294 -4327 -4354 -4379 -4359 -4276 -4187 -4173 -4195 -4225 -4238 -4223 -4169 -4064 -3888 -3630 -3351 -3117 -2955
 -4374 -4415 -4458 -4476 -4504 -4541 -4578 -4597 -4603 -4594 -4574 -4544 -4514 -4480 -4460 -4447 -4453 -4449 -4447 -4394 -4354 -4316 -4335 -4378 -4468 -4445 -4467 -4381 -4372 -4281 -4256 -4236 -4240 -4252 -4262 -4284 -4277 -4235 -4192 -4162 -4156 -4132 -4091 -4032 -3929 -3817 -3636 -3442 -3203 -3016 -2862
 -4291 -4323 -4352 -4386 -4429 -4483 -4533 -4568 -4585 -4585 -4572 -4549 -4520 -4488 -4460 -4436 -4416 -4390 -4342 -4254 -4161 -4095 -4076 -4108 -4156 -4177 -4188 -4193 -4205 -4206 -4211 -4208 -4209 -4216 -4230 -4248 -4252 -4235 -4205 -4171 -4129 -4065 -3982 -3883 -3770 -3649 -3508 -3346 -3169 -3010 -2898
 -4212 -4230 -4244 -4297 -4356 -4429 -4493 -4538 -4564 -4571 -4563 -4541 -4511 -4472 -4430 -4384 -4333 -4279 -4202 -4076 -3942 -3856 -3797 -3821 -3834 -3875 -3872 -3953 -3998 -4089 -4147 -4172 -4188 -4202 -4223 -4249 -4266 -4257 -4225 -4190 -4119 -4013 -3888 -3758 -3642 -3531 -3434 -3306 -3185 -3054 -2961
 -4167 -4178 -4196 -4250 -4321 -4398 -4464 -4512 -4540 -4549 -4541 -4518 -4481 -4432 -4372 -4302 -4224 -4136 -4031 -3902 -3774 -3681 -3631 -3641 -3673 -3717 -3764 -3846 -3930 -4021 -4089 -4133 -4161 -4192 -4224 -4257 -4280 -4286 -4265 -4217 -4118 -3962 -3789 -3638 -3517 -3420 -3341 -3266 -3189 -3100 -3029
 -4161 -4171 -4186 -4248 -4320 -4390 -4449 -4491 -4514 -4520 -4508 -4479 -4434 -4371 -4294 -4201 -4099 -3988 -3874 -3756 -3648 -3573 -3535 -3562 -3620 -3681 -3757 -3851 -3941 -4018 -4066 -4116 -4142 -4186 -4215 -4246 -4267 -4283 -4271 -4219 -4105 -3900 -3681 -3530 -3413 -3329 -3261 -3224 -3190 -3125 -3075
 -4182 -4206 -4238 -4291 -4350 -4402 -4443 -4472 -4486 -4483 -4463 -4426 -4370 -4295 -4203 -4095 -3976 -3857 -3744 -3652 -3579 -3531 -3520 -3554 -3623 -3708 -3810 -3915 -4009 -4064 -4101 -4135 -4161 -4179 -4187 -4190 -4199 -4209 -4206 -4144 -4019 -3810 -3599 -3451 -3350 -3274 -3217 -3182 -3153 -3119 -3090
 -4224 -4261 -4302 -4348 -4393 -4423 -4441 -4453 -4452 -4436 -4406 -4359 -4295 -4212 -4115 -4003 -3882 -3771 -3661 -3598 -3552 -3527 -3535 -3578 -3655 -3746 -3862 -3969 -4075 -4101 -4121 -4136 -4148 -4121 -4091 -4042 -4025 -4008 -4022 -3943 -3862 -3667 -3493 -3386 -3316 -3245 -3192 -3154 -3126 -3107 -3094
 -4272 -4312 -4352 -4391 -4423 -4437 -4438 -4428 -4408 -4378 -4336 -4279 -4210 -4129 -4037 -3943 -3845 -3750 -3663 -3593 -3549 -3535 -3554 -3603 -3674 -3759 -3856 -3957 -4037 -4071 -4074 -4061 -4029 -3956 -3871 -3776 -3703 -3656 -3624 -3584 -3531 -3464 -3394 -3333 -3279 -3228 -3184 -3152 -3129 -3120 -3118
 -4315 -4346 -4377 -4404 -4428 -4425 -4417 -4389 -4354 -4307 -4255 -4191 -4127 -4064 -3988 -3924 -3841 -3758 -3684 -3601 -3550 -3541 -3566 -3617 -3684 -3752 -3821 -3911 -3966 -3987 -3955 -3887 -3809 -3679 -3570 -3442 -3337 -3280 -3225 -3234 -3218 -3278 -3306 -3291 -3257 -3226 -3196 -3180 -3166 -3166 -3168
 -4341 -4356 -4366 -4373 -4378 -4375 -4362 -4332 -4286 -4226 -4160 -4099 -4052 -4030 -4002 -3940 -3854 -3755 -3662 -3586 -3543 -3536 -3564 -3615 -3679 -3743 -3804 -3864 -3892 -3864 -3774 -3613 -3441 -3308 -3202 -3116 -3048 -3024 -3021 -3056 -3106 -3184 -3245 -3264 -3257 -3245 -3238 -3240 -3246 -3250 -3257
 -4356 -4343 -4328 -4310 -4305 -4308 -4303 -4272 -4222 -4151 -4078 -4020 -3981 -3996 -4015 -3934 -3844 -3721 -3616 -3547 -3515 -3511 -3545 -3590 -3660 -3723 -3772 -3792 -3777 -3678 -3548 -3304 -3065 -2975 -2900 -2888 -2869 -2915 -2958 -3021 -3092 -3165 -3229 -3259 -3268 -3277 -3289 -3313 -3340 -3351 -3363
 -4360 -4317 -4267 -4237 -4230 -4251 -4259 -4228 -4166 -4100 -4032 -3978 -3944 -3935 -3918 -3853 -3758 -3652 -3557 -3493 -3463 -3466 -3498 -3547 -3610 -3683 -3718 -3670 -3561 -3405 -3222 -3035 -2881 -2810 -2795 -2825 -2879 -2949 -3019 -3073 -3127 -3184 -3238 -3272 -3295 -3315 -3342 -3377 -3415 -3444 -3472
 -4372 -4308 -4227 -4202 -4187 -4237 -4262 -4231 -4148 -4091 -4017 -3960 -3911 -3874 -3822 -3757 -3662 -3575 -3493 -3439 -3418 -3441 -3481 -3537 -3567 -3625 -3634 -3512 -3338 -3154 -2949 -2850 -2785 -2759 -2791 -2852 -2955 -3033 -3122 -3147 -3178 -3220 -3267 -3296 -3323 -3345 -3378 -3416 -3471 -3521 -3579
 -4395 -4336 -4277 -4248 -4251 -4289 -4312 -4288 -4221 -4129 -4035 -3956 -3894 -3841 -3781 -3706 -3613 -3523 -3450 -3409 -3415 -3477 -3550 -3610 -3613 -3548 -3445 -3333 -3197 -3030 -2873 -2786 -2753 -2758 -2804 -2884 -2985 -3076 -3151 -3192 -3223 -3258 -3293 -3320 -3341 -3358 -3382 -3422 -3487 -3579 -3686
 -4415 -4362 -4332 -4320 -4334 -4367 -4372 -4335 -4273 -4146 -4039 -3950 -3884 -3838 -3783 -3704 -3604 -3500 -3429 -3415 -3457 -3592 -3681 -3716 -3662 -3457 -3251 -3192 -3131 -2998 -2873 -2800 -2777 -2788 -2835 -2919 -3011 -3098 -3165 -3218 -3258 -3295 -3325 -3349 -3364 -3371 -3385 -3425 -3498 -3633 -3786
 -4395 -4348 -4330 -4361 -4406 -4407 -4374 -4289 -4190 -4084 -3995 -3929 -3885 -3853 -3812 -3736 -3630 -3508 -3433 -3478 -3607 -3778 -3872 -3777 -3579 -3362 -3197 -3132 -3090 -3002 -2909 -2850 -2832 -2844 -2890 -2968 -3055 -3125 -3185 -3244 -3296 -3334 -3363 -3385 -3398 -3401 -3413 -3463 -3556 -3701 -3867
 -4371 -4308 -4273 -4325 -4394 -4315 -4254 -4119 -4030 -3965 -3921 -3893 -3880 -3863 -3844 -3772 -3689 -3564 -3476 -3585 -3742 -3903 -4006 -3743 -3448 -3276 -3169 -3126 -3105 -3019 -2948 -2911 -2913 -2922 -2960 -3035 -3119 -3165 -3212 -3275 -3338 -3370 -3401 -3429 -3456 -3465 -3480 -3550 -3646 -3789 -3944
 -4352 -4273 -4212 -4196 -4154 -4022 -3885 -3831 -3827 -3836 -3844 -3854 -3858 -3851 -3825 -3779 -3723 -3679 -3676 -3734 -3810 -3830 -3762 -3568 -3359 -3239 -3180 -3138 -3093 -3034 -2987 -2981 -2999 -3022 -3059 -3117 -3176 -3222 -3264 -3320 -3372 -3407 -3438 -3483 -3530 -3571 -3622 -3698 -3794 -3904 -4018
 -4354 -4254 -4131 -4051 -3918 -3714 -3498 -3565 -3662 -3740 -3791 -3836 -3850 -3848 -3817 -3792 -3764 -3788 -3838 -3822 -3803 -3671 -3489 -3382 -3270 -3233 -3221 -3176 -3125 -3091 -3057 -3091 -3125 -3159 -3186 -3237 -3277 -3319 -3347 -3401 -3442 -3474 -3499 -3566 -3636 -3707 -3785 -3868 -3960 -4035 -4106
 -4381 -4262 -4116 -3956 -3771 -3573 -3441 -3475 -3588 -3707 -3800 -3862 -3889 -3885 -3864 -3843 -3833 -3836 -3831 -3776 -3675 -3533 -3392 -3316 -3276 -3260 -3252 -3244 -3236 -3232 -3240 -3270 -3307 -3341 -3374 -3411 -3445 -3475 -3504 -3537 -3569 -3599 -3636 -3697 -3772 -3855 -3941 -4026 -4104 -4168 -4224
 -4384 -4245 -4092 -3898 -3716 -3551 -3474 -3509 -3616 -3738 -3845 -3909 -3946 -3941 -3924 -3898 -3880 -3835 -3773 -3687 -3562 -3465 -3379 -3348 -3346 -3333 -3323 -3354 -3389 -3417 -3453 -3479 -3513 -3545 -3579 -3608 -3638 -3658 -3682 -3703 -3730 -3758 -3798 -3854 -3924 -4005 -4087 -4167 -4237 -4295 -4347
 -4286 -4158 -4007 -3840 -3687 -3576 -3544 -3606 -3717 -3814 -3892 -3950 -3984 -3986 -3966 -3930 -3879 -3814 -3732 -3649 -3562 -3495 -3453 -3441 -3449 -3459 -3475 -3509 -3553 -3597 -3640 -3674 -3706 -3738 -3768 -3793 -3813 -3827 -3844 -3866 -3893 -3924 -3963 -4013 -4074 -4145 -4219 -4289 -4353 -4406 -4450
 -4157 -4045 -3921 -3801 -3693 -3629 -3624 -3728 -3855 -3909 -3944 -3988 -4017 -4020 -3999 -3959 -3886 -3821 -3732 -3676 -3624 -3586 -3569 -3573 -3590 -3622 -3656 -3685 -3719 -3760 -3804 -3837 -3872 -3901 -3931 -3948 -3963 -3968 -3981 -4006 -4041 -4070 -4108 -4150 -4203 -4262 -4327 -4391 -4449 -4497 -4534
 -4043 -3955 -3873 -3795 -3735 -3716 -3752 -3847 -3944 -3990 -4008 -4026 -4041 -4045 -4035 -4007 -3958 -3887 -3812 -3755 -3719 -3701 -3704 -3724 -3758 -3798 -3834 -3857 -3876 -3898 -3926 -3959 -3994 -4024 -4049 -4063 -4069 -4070 -4081 -4110 -4147 -4178 -4210 -4247 -4293 -4343 -4401 -4463 -4521 -4564 -4594
 -3968 -3915 -3865 -3820 -3794 -3808 -3861 -3944 -4025 -4048 -4051 -4055 -4058 -4060 -4057 -4045 -4028 -3954 -3895 -3839 -3816 -3811 -3833 -3867 -3917 -3958 -3997 -4008 -4014 -4020 -4029 -4058 -4086 -4112 -4132 -4139 -4143 -4140 -4146 -4181 -4221 -4243 -4268 -4300 -4343 -4385 -4438 -4502 -4567 -4606 -4635
 -4002 -3933 -3887 -3860 -3859 -3888 -3941 -4004 -4056 -4073 -4072 -4070 -4066 -4059 -4050 -4035 -4010 -3965 -3920 -3888 -3880 -3894 -3929 -3977 -4030 -4076 -4110 -4125 -4131 -4132 -4136 -4148 -4161 -4172 -4179 -4182 -4184 -4188 -4200 -4225 -4250 -4267 -4284 -4311 -4348 -4390 -4443 -4505 -4569 -4620 -4659
 -4042 -3964 -3919 -3899 -3910 -3943 -3989 -4033 -4065 -4073 -4067 -4066 -4060 -4043 -4023 -3999 -3969 -3943 -3917 -3912 -3923 -3957 -4004 -4063 -4117 -4162 -4194 -4213 -4225 -4229 -4231 -4228 -4225 -4221 -4213 -4212 -4210 -4219 -4233 -4247 -4262 -4268 -4276 -4298 -4330 -4371 -4423 -4485 -4552 -4615 -4669
 -4019 -3965 -3932 -3924 -3940 -3972 -4007 -4033 -4047 -4049 -4047 -4041 -4032 -4012 -3988 -3962 -3938 -3923 -3917 -3929 -3959 -4008 -4069 -4135 -4192 -4228 -4253 -4277 -4297 -4306 -4305 -4297 -4284 -4270 -4255 -4243 -4237 -4239 -4247 -4255 -4261 -4265 -4270 -4283 -4306 -4344 -4395 -4458 -4529 -4604 -4666
 -3968 -3942 -3928 -3932 -3951 -3980 -4006 -4012 -4011 -3999 -4000 -3991 -3992 -3974 -3954 -3934 -3919 -3914 -3922 -3948 -3990 -4051 -4121 -4194 -4258 -4285 -4300 -4334 -4358 -4370 -4367 -4356 -4338 -4318 -4298 -4278 -4264 -4259 -4258 -4263 -4267 -4272 -4276 -4284 -4296 -4329 -4375 -4446 -4522 -4605 -4670
 -3926 -3917 -3917 -3928 -3948 -3971 -3985 -3978 -3955 -3929 -3911 -3921 -3935 -3938 -3930 -3921 -3916 -3921 -3939 -3974 -4025 -4091 -4164 -4238 -4300 -4339 -4367 -4395 -4417 -4426 -4422 -4407 -4386 -4362 -4338 -4316 -4298 -4287 -4283 -4286 -4293 -4302 -4308 -4317 -4325 -4344 -4387 -4471 -4563 -4636 -4684
 -3895 -3899 -3905 -3921 -3937 -3956 -3963 -3952 -3920 -3892 -3851 -3888 -3910 -3928 -3929 -3932 -3934 -3947 -3969 -4009 -4063 -4130 -4203 -4277 -4340 -4389 -4426 -4450 -4468 -4471 -4465 -4447 -4425 -4401 -4377 -4355 -4336 -4326 -4320 -4328 -4336 -4353 -4362 -4377 -4383 -4390 -4420 -4529 -4641 -4697 -4722
 -3890 -3898 -3908 -3918 -3929 -3940 -3947 -3949 -3945 -3936 -3930 -3939 -3952 -3963 -3969 -3974 -3981 -3995 -4019 -4057 -4109 -4173 -4244 -4318 -4384 -4433 -4467 -4487 -4497 -4497 -4489 -4473 -4453 -4432 -4412 -4395 -4382 -4376 -4377 -4385 -4400 -4420 -4439 -4448 -4456 -4468 -4515 -4615 -4718 -4774 -4803
 -3898 -3906 -3915 -3916 -3918 -3921 -3930 -3953 -3985 -4005 -4035 -4024 -4024 -4025 -4032 -4038 -4047 -4060 -4080 -4115 -4160 -4219 -4285 -4359 -4426 -4468 -4494 -4507 -4511 -4510 -4502 -4489 -4474 -4460 -4445 -4433 -4425 -4422 -4431 -4436 -4452 -4463 -4491 -4491 -4519 -4541 -4602 -4702 -4805 -4844 -4875
 -3905 -3913 -3916 -3909 -3899 -3894 -3907 -3941 -3991 -4039 -4074 -4083 -4086 -4092 -4103 -4113 -4123 -4135 -4152 -4178 -4216 -4266 -4327 -4393 -4452 -4490 -4509 -4517 -4517 -4514 -4508 -4500 -4492 -4485 -4477 -4463 -4453 -4451 -4456 -4461 -4460 -4448 -4447 -4470 -4519 -4589 -4674 -4767 -4843 -4878 -4902
 -3914 -3926 -3924 -3904 -3877 -3854 -3865 -3911 -3983 -4050 -4098 -4123 -4134 -4153 -4174 -4188 -4200 -4207 -4220 -4237 -4267 -4307 -4360 -4420 -4475 -4504 -4517 -4520 -4516 -4513 -4509 -4505 -4503 -4503 -4502 -4479 -4467 -4474 -4479 -4475 -4453 -4404 -4380 -4444 -4525 -4640 -4735 -4818 -4878 -4902 -4913
 -3933 -3947 -3942 -3904 -3850 -3804 -3801 -3871 -3971 -4060 -4121 -4156 -4177 -4204 -4232 -4252 -4264 -4268 -4272 -4283 -4304 -4338 -4385 -4440 -4488 -4513 -4521 -4520 -4515 -4511 -4508 -4509 -4510 -4509 -4500 -4479 -4473 -4504 -4525 -4491 -4427 -4373 -4374 -4475 -4612 -4725 -4807 -4863 -4904 -4943 -4982
 -3944 -3965 -3969 -3915 -3842 -3778 -3748 -3851 -3976 -4075 -4147 -4185 -4208 -4246 -4281 -4305 -4318 -4318 -4316 -4322 -4336 -4364 -4403 -4457 -4504 -4521 -4522 -4518 -4513 -4507 -4507 -4515 -4521 -4522 -4510 -4493 -4480 -4542 -4587 -4519 -4429 -4386 -4393 -4541 -4722 -4810 -4876 -4910 -4935 -4991 -5049
 -3938 -3968 -3972 -3933 -3871 -3816 -3807 -3881 -3991 -4088 -4163 -4209 -4245 -4282 -4319 -4346 -4360 -4361 -4358 -4362 -4374 -4396 -4430 -4476 -4514 -4527 -4524 -4517 -4509 -4504 -4508 -4529 -4549 -4552 -4546 -4549 -4563 -4589 -4593 -4552 -4498 -4477 -4511 -4616 -4745 -4850 -4923 -4963 -4994 -5035 -5077
 -3932 -3969 -3983 -3962 -3924 -3887 -3883 -3933 -4019 -4094 -4169 -4216 -4263 -4304 -4345 -4376 -4396 -4402 -4401 -4411 -4421 -4441 -4461 -4500 -4531 -4535 -4528 -4523 -4516 -4513 -4515 -4555 -4591 -4595 -4595 -4621 -4650 -4644 -4620 -4603 -4586 -4591 -4633 -4697 -4774 -4885 -4968 -5012 -5043 -5068 -5094
 -3948 -3981 -3999 -3997 -3982 -3964 -3960 -3980 -4023 -4081 -4142 -4200 -4254 -4306 -4353 -4392 -4421 -4441 -4457 -4471 -4486 -4501 -4516 -4533 -4545 -4547 -4544 -4541 -4541 -4546 -4561 -4591 -4621 -4640 -4656 -4680 -4701 -4701 -4689 -4674 -4669 -4683 -4723 -4784 -4860 -4945 -5011 -5048 -5069 -5095 -5125
 -3970 -3999 -4023 -4034 -4038 -4033 -4029 -4029 -4037 -4082 -4128 -4190 -4244 -4304 -4355 -4397 -4436 -4470 -4503 -4523 -4544 -4554 -4566 -4563 -4561 -4560 -4561 -4563 -4572 -4583 -4605 -4625 -4650 -4672 -4698 -4717 -4735 -4746 -4754 -4735 -4730 -4739 -4777 -4847 -4937 -5005 -5059 -5080 -5087 -5119 -5152
 -3981 -4014 -4044 -4067 -4081 -4088 -4090 -4090 -4098 -4125 -4165 -4214 -4264 -4312 -4356 -4395 -4435 -4480 -4521 -4549 -4568 -4579 -4584 -4582 -4578 -4575 -4575 -4580 -4591 -4608 -4628 -4644 -4661 -4682 -4706 -4727 -4746 -4762 -4769 -4762 -4753 -4759 -4792 -4863 -4954 -5032 -5091 -5115 -5128 -5153 -5182
 -3989 -4028 -4064 -4093 -4115 -4132 -4144 -4155 -4169 -4192 -4225 -4261 -4300 -4332 -4363 -4394 -4428 -4477 -4524 -4552 -4571 -4584 -4590 -4594 -4593 -4591 -4589 -4596 -4605 -4624 -4641 -4652 -4661 -4678 -4696 -4715 -4734 -4756 -4766 -4766 -4753 -4753 -4772 -4830 -4924 -5011 -5107 -5141 -5163 -5193 -5219
 -3998 -4039 -4078 -4111 -4139 -4165 -4188 -4209 -4233 -4258 -4287 -4313 -4337 -4360 -4381 -4405 -4434 -4473 -4512 -4542 -4564 -4582 -4595 -4604 -4608 -4607 -4607 -4613 -4624 -4637 -4648 -4655 -4662 -4670 -4679 -4689 -4706 -4732 -4756 -4756 -4748 -4740 -4743 -4769 -4830 -4945 -5062 -5143 -5196 -5233 -5265
 -4006 -4048 -4087 -4119 -4150 -4178 -4211 -4238 -4273 -4304 -4338 -4357 -4375 -4392 -4408 -4425 -4446 -4476 -4505 -4534 -4557 -4581 -4599 -4612 -4620 -4618 -4619 -4626 -4638 -4644 -4650 -4655 -4658 -4658 -4657 -4650 -4656 -4679 -4723 -4717 -4725 -4719 -4726 -4742 -4767 -4918 -5043 -5139 -5208 -5256 -5305
 -4012 -4051 -4087 -4117 -4143 -4168 -4197 -4230 -4271 -4317 -4359 -4387 -4408 -4425 -4440 -4455 -4472 -4493 -4516 -4540 -4563 -4584 -4601 -4613 -4620 -4621 -4622 -4628 -4635 -4642 -4647 -4649 -4648 -4640 -4626 -4604 -4589 -4595 -4613 -4638 -4664 -4693 -4737 -4807 -4898 -5003 -5089 -5140 -5184 -5254 -5327
 -4014 -4050 -4082 -4109 -4129 -4147 -4167 -4204 -4251 -4312 -4368 -4407 -4434 -4456 -4473 -4487 -4502 -4519 -4537 -4556 -4574 -4590 -4603 -4612 -4616 -4617 -4616 -4619 -4624 -4632 -4638 -4640 -4638 -4626 -4606 -4575 -4543 -4549 -4548 -4602 -4637 -4692 -4770 -4911 -5068 -5131 -5170 -5158 -5158 -5261 -5359
 -4010 -4043 -4073 -4098 -4116 -4127 -4144 -4184 -4240 -4307 -4370 -4419 -4455 -4481 -4501 -4517 -4531 -4546 -4560 -4573 -4585 -4594 -4603 -4610 -4612 -4610 -4606 -4605 -4609 -4616 -4624 -4629 -4628 -4621 -4605 -4586 -4581 -4609 -4647 -4684 -4710 -4750 -4836 -4999 -5153 -5210 -5210 -5196 -5220 -5312 -5414
 -4001 -4031 -4058 -4083 -4103 -4115 -4129 -4181 -4240 -4311 -4376 -4428 -4468 -4500 -4523 -4541 -4556 -4569 -4580 -4588 -4594 -4598 -4601 -4608 -4608 -4599 -4588 -4582 -4585 -4596 -4609 -4626 -4633 -4641 -4635 -4627 -4650 -4734 -4826 -4848 -4848 -4862 -4908 -5080 -5230 -5248 -5230 -5235 -5278 -5368 -5472
 -3989 -4013 -4035 -4057 -4081 -4109 -4148 -4204 -4266 -4329 -4384 -4433 -4475 -4508 -4536 -4557 -4573 -4585 -4592 -4597 -4599 -4601 -4603 -4604 -4599 -4583 -4563 -4551 -4552 -4569 -4599 -4634 -4667 -4691 -4698 -4695 -4737 -4871 -5001 -5025 -5010 -5022 -5080 -5169 -5240 -5252 -5245 -5272 -5326 -5391 -5447
 -3973 -3985 -3998 -4012 -4041 -4083 -4150 -4222 -4296 -4351 -4389 -4430 -4471 -4503 -4537 -4561 -4580 -4591 -4594 -4598 -4597 -4598 -4595 -4589 -4579 -4561 -4533 -4513 -4503 -4529 -4578 -4638 -4701 -4751 -4788 -4782 -4805 -4992 -5172 -5152 -5124 -5147 -5223 -5246 -5266 -5269 -5261 -5316 -5369 -5403 -5415
 